Abstraction -> Model::Abstraction
AcceptCallAction -> Model::Activity::AcceptCallAction
AcceptEventAction -> Model::Activity::AcceptEventAction
ActionExecutionSpecification -> Model::Activity::Interaction::ActionExecutionSpecification
ActionInputPin -> Model::Activity::ActionInputPin
Activity -> Model::Activity
ActivityFinalNode -> Model::Activity::ActivityFinalNode
ActivityParameterNode -> Model::Activity::ActivityParameterNode
ActivityPartition -> Model::Activity::ActivityPartition
Actor -> Model::Activity::Actor
AddStructuralFeatureValueAction -> Model::Activity::AddStructuralFeatureValueAction
AddVariableValueAction -> Model::Activity::AddVariableValueAction
AnyReceiveEvent -> Model::AnyReceiveEvent
Artifact -> Model::Activity::Artifact
Association -> Model::Activity::Association
AssociationClass -> Model::Activity::AssociationClass
BehaviorExecutionSpecification -> Model::Activity::Interaction::BehaviorExecutionSpecification
BroadcastSignalAction -> Model::Activity::BroadcastSignalAction
CallBehaviorAction -> Model::Activity::CallBehaviorAction
CallEvent -> Model::CallEvent
CallOperationAction -> Model::Activity::CallOperationAction
CentralBufferNode -> Model::Activity::CentralBufferNode
ChangeEvent -> Model::ChangeEvent
Class -> Model::Activity::Class
ClassifierTemplateParameter -> Model::TemplateSignature::ClassifierTemplateParameter
Clause -> Model::Activity::ConditionalNode::Clause
ClearAssociationAction -> Model::Activity::ClearAssociationAction
ClearStructuralFeatureAction -> Model::Activity::ClearStructuralFeatureAction
ClearVariableAction -> Model::Activity::ClearVariableAction
Collaboration -> Model::Activity::Collaboration
CollaborationUse -> Model::Activity::CollaborationUse
CombinedFragment -> Model::Activity::Interaction::CombinedFragment
Comment -> Model::Comment
CommunicationPath -> Model::Activity::CommunicationPath
Component -> Model::Activity::Component
ComponentRealization -> Model::Activity::CollaborationUse::ComponentRealization
ConditionalNode -> Model::Activity::ConditionalNode
ConnectableElementTemplateParameter -> Model::TemplateSignature::ConnectableElementTemplateParameter
ConnectionPointReference -> Model::Activity::ProtocolStateMachine::Region::ConnectionPointReference
Connector -> Model::Activity::Connector
ConnectorEnd -> Model::Activity::Connector::ConnectorEnd
ConsiderIgnoreFragment -> Model::Activity::Interaction::ConsiderIgnoreFragment
Constraint -> Model::Activity::ConditionalNode::Constraint
Continuation -> Model::Activity::Interaction::Continuation
ControlFlow -> Model::Activity::ControlFlow
CreateLinkAction -> Model::Activity::CreateLinkAction
CreateLinkObjectAction -> Model::Activity::CreateLinkObjectAction
CreateObjectAction -> Model::Activity::CreateObjectAction
DataStoreNode -> Model::Activity::DataStoreNode
DataType -> Model::Activity::DataType
DecisionNode -> Model::Activity::DecisionNode
Dependency -> Model::Activity::CollaborationUse::Dependency
Deployment -> Model::Activity::CollaborationUse::Deployment
DeploymentSpecification -> Model::Activity::Artifact::DeploymentSpecification
DestroyLinkAction -> Model::Activity::DestroyLinkAction
DestroyObjectAction -> Model::Activity::DestroyObjectAction
DestructionOccurrenceSpecification -> Model::Activity::Interaction::DestructionOccurrenceSpecification
Device -> Model::Activity::Device
Duration -> Model::Activity::ControlFlow::Duration
DurationConstraint -> Model::Activity::ConditionalNode::DurationConstraint
DurationInterval -> Model::Activity::ControlFlow::DurationInterval
DurationObservation -> Model::Activity::Component::DurationObservation
ElementImport -> Model::ElementImport
Enumeration -> Model::Activity::Enumeration
EnumerationLiteral -> Model::Activity::Component::EnumerationLiteral
ExceptionHandler -> Model::Activity::ConditionalNode::ExceptionHandler
ExecutionEnvironment -> Model::Activity::ExecutionEnvironment
ExecutionOccurrenceSpecification -> Model::Activity::Interaction::ExecutionOccurrenceSpecification
ExpansionNode -> Model::Activity::ExpansionNode
ExpansionRegion -> Model::Activity::ExpansionRegion
Expression -> Model::ChangeEvent::Expression
Extend -> Model::Activity::UseCase::Extend
Extension -> Model::Activity::Extension
ExtensionEnd -> Model::Activity::Artifact::ExtensionEnd
ExtensionPoint -> Model::Activity::UseCase::ExtensionPoint
FinalState -> Model::Activity::ProtocolStateMachine::Region::FinalState
FlowFinalNode -> Model::Activity::FlowFinalNode
ForkNode -> Model::Activity::ForkNode
FunctionBehavior -> Model::Activity::FunctionBehavior
Gate -> Model::Activity::Interaction::CombinedFragment::Gate
Generalization -> Model::Activity::Generalization
GeneralizationSet -> Model::Activity::Component::GeneralizationSet
GeneralOrdering -> Model::Activity::Interaction::GeneralOrdering
Image -> Model::Activity::Stereotype::Image
Include -> Model::Activity::UseCase::Include
InformationFlow -> Model::Activity::Component::InformationFlow
InformationItem -> Model::Activity::InformationItem
InitialNode -> Model::Activity::InitialNode
InputPin -> Model::Activity::InputPin
InstanceSpecification -> Model::Activity::Component::InstanceSpecification
InstanceValue -> Model::Activity::Component::InstanceValue
Interaction -> Model::Activity::Interaction
InteractionConstraint -> Model::Activity::ConditionalNode::InteractionConstraint
InteractionOperand -> Model::Activity::Interaction::InteractionOperand
InteractionUse -> Model::Activity::Interaction::InteractionUse
Interface -> Model::Activity::Interface
InterfaceRealization -> Model::Activity::InterfaceRealization
InterruptibleActivityRegion -> Model::Activity::InterruptibleActivityRegion
Interval -> Model::Activity::Component::Interval
IntervalConstraint -> Model::Activity::ConditionalNode::IntervalConstraint
JoinNode -> Model::Activity::JoinNode
Lifeline -> Model::Activity::Interaction::Lifeline
LinkEndCreationData -> Model::Activity::CreateLinkAction::LinkEndCreationData
LinkEndData -> Model::Activity::ReadLinkAction
LinkEndDestructionData -> Model::Activity::DestroyLinkAction
LiteralBoolean -> Model::Activity::Component::LiteralBoolean
LiteralInteger -> Model::Activity::Component::LiteralInteger
LiteralNull -> Model::Activity::Component::LiteralNull
LiteralReal -> Model::Activity::Component::LiteralReal
LiteralString -> Model::Activity::Component::LiteralString
LiteralUnlimitedNatural -> Model::Activity::Component::LiteralUnlimitedNatural
LoopNode -> Model::Activity::LoopNode
Manifestation -> Model::Activity::Artifact::Manifestation
MergeNode -> Model::Activity::MergeNode
Message -> Model::Activity::Interaction::Message
MessageOccurrenceSpecification -> Model::Activity::Interaction::MessageOccurrenceSpecification
Model -> Model
Node -> Model::Activity::Node
ObjectFlow -> Model::Activity::ObjectFlow
OccurrenceSpecification -> Model::Activity::Interaction::OccurrenceSpecification
OpaqueAction -> Model::Activity::OpaqueAction
OpaqueBehavior -> Model::Activity::OpaqueBehavior
OpaqueExpression -> Model::Abstraction::OpaqueExpression
Operation -> Model::Activity::Artifact::Operation
OperationTemplateParameter -> Model::TemplateSignature::OperationTemplateParameter
OutputPin -> Model::Activity::OutputPin
Package -> Model::Package
PackageImport -> Model::PackageImport
PackageImport -> Model::PackageImport
PackageMerge -> Model::PackageMerge
Parameter -> Model::Activity::Parameter
ParameterSet -> Model::Activity::ParameterSet
PartDecomposition -> Model::Activity::Interaction::PartDecomposition
Port -> Model::Activity::Artifact::Port
PrimitiveType -> Model::Activity::PrimitiveType
Profile -> Model::Activity::Component::Profile
ProfileApplication -> Model::ProfileApplication
Property -> Model::Activity::Artifact::Property
ProtocolConformance -> Model::Activity::ProtocolStateMachine::ProtocolConformance
ProtocolStateMachine -> Model::Activity::ProtocolStateMachine
ProtocolTransition -> Model::Activity::ProtocolStateMachine::Region::ProtocolTransition
Pseudostate -> Model::Activity::ProtocolStateMachine::Pseudostate
QualifierValue -> Model::Activity::CreateLinkAction::LinkEndCreationData::QualifierValue
RaiseExceptionAction -> Model::Activity::RaiseExceptionAction
ReadExtentAction -> Model::Activity::ReadExtentAction
ReadIsClassifiedObjectAction -> Model::Activity::ReadIsClassifiedObjectAction
ReadLinkAction -> Model::Activity::ReadLinkAction
ReadLinkObjectEndAction -> Model::Activity::ReadLinkObjectEndAction
ReadLinkObjectEndQualifierAction -> Model::Activity::ReadLinkObjectEndQualifierAction
ReadSelfAction -> Model::Activity::ReadSelfAction
ReadStructuralFeatureAction -> Model::Activity::ReadStructuralFeatureAction
ReadVariableAction -> Model::Activity::ReadVariableAction
Realization -> Model::Activity::CollaborationUse::Realization
Reception -> Model::Activity::Reception
ReclassifyObjectAction -> Model::Activity::ReclassifyObjectAction
RedefinableTemplateSignature -> Model::Activity::Class
ReduceAction -> Model::Activity::ReduceAction
Region -> Model::Activity::ProtocolStateMachine::Region
RemoveStructuralFeatureValueAction -> Model::Activity::RemoveStructuralFeatureValueAction
RemoveVariableValueAction -> Model::Activity::RemoveVariableValueAction
ReplyAction -> Model::Activity::ReplyAction
SendObjectAction -> Model::Activity::SendObjectAction
SendSignalAction -> Model::Activity::SendSignalAction
SequenceNode -> Model::Activity::SequenceNode
Signal -> Model::Activity::Signal
SignalEvent -> Model::Activity::Component::SignalEvent
Slot -> Model::Activity::Component::EnumerationLiteral::Slot
StartClassifierBehaviorAction -> Model::Activity::StartClassifierBehaviorAction
StartObjectBehaviorAction -> Model::Activity::StartObjectBehaviorAction
State -> Model::Activity::ProtocolStateMachine::Region::State
StateInvariant -> Model::Activity::Interaction::StateInvariant
StateMachine -> Model::Activity::StateMachine
Stereotype -> Model::Activity::Stereotype
StringExpression -> Model::Activity::Component::StringExpression
StructuredActivityNode -> Model::Activity::StructuredActivityNode
Substitution -> Model::Activity::Substitution
TemplateBinding -> Model::TemplateBinding
TemplateParameter -> Model::TemplateSignature::TemplateParameter
TemplateParameterSubstitution -> Model::TemplateBinding::TemplateParameterSubstitution
TemplateSignature -> Model::TemplateSignature
TestIdentityAction -> Model::Activity::TestIdentityAction
TimeConstraint -> Model::Activity::ConditionalNode::TimeConstraint
TimeEvent -> Model::Activity::Component::TimeEvent
TimeExpression -> Model::Activity::Component::TimeExpression
TimeInterval -> Model::Activity::Component::TimeInterval
TimeObservation -> Model::Activity::Component::TimeObservation
Transition -> Model::Activity::ProtocolStateMachine::Region::Transition
Trigger -> Model::Activity::ProtocolStateMachine::Region::State::Trigger
UnmarshallAction -> Model::Activity::UnmarshallAction
Usage -> Model::Activity::CollaborationUse::Usage
UseCase -> Model::Activity::UseCase
ValuePin -> Model::Activity::ValuePin
ValueSpecificationAction -> Model::Activity::ValueSpecificationAction
Variable -> Model::Activity::Variable